11111111111111111111111111
10000000010000000000000001
10000011010000100011111111
10000000010000000010000001
10001100010000000010000001
10000000010000100010000001
10000110010000100010000001
10000000000000100000000001
10000100111000100000111111
10000100111000100000000001
10000100000000100000000001
11100111111111110000110001
10000000100000000000000001
10000000100000001000001111
10000000100000001000001111
10000000100000001000001111
11111111111111111111111111